2048 2052 2076 2076 2076 2076 2076 2056 2048 2048
2048 2072 2898 2900 2858 2946 2948 2064 2048 2048
2048 2072 2904 2902 2860 2952 2950 2064 2048 2048
2048 2050 2068 2068 2068 2068 2068 2049 2048 2048
2048 2048 2048 2048 2048 2048 2048 2048 2048 2048
2048 2048 2048 2052 2076 2056 2048 2048 2048 2048
2048 2052 2076 2086 2954 2088 2076 2056 2048 2048
2048 2072 2907 2909 2956 2907 2909 2064 2048 2048
2048 2050 2068 2068 2068 2068 2068 2049 2048 2048
2048 2048 2048 2048 2048 2048 2048 2048 2048 2048
0 0 0 0 0 0 0 0 0 0
0 0 0 0 3050 0 3822 0 0 0
0 0 3054 0 3052 3822 0 0 0 0
0 0 0 0 0 0 0 0 0 0
0 0 0 0 0 2190 0 0 0 0
0 0 2190 0 0 0 0 0 0 0
0 0 0 0 3434 0 0 0 0 0
0 0 3435 3425 3423 3425 3437 0 0 0
0 0 0 0 0 0 0 0 0 0
0 0 0 0 0 0 0 0 0 3426