2047 2076 2134 2088 2060 2076 2672 2748 2768 2652
2957 2862 2910 2958 2483 2910 2958 2862 2385 2273
3341 3246 3150 3342 3246 3294 3342 3246 2769 2657
2957 3531 3533 2958 2862 2910 2958 2862 2385 2273
2770 3915 3917 2763 2770 3294 3342 3246 3294 3339
3137 3149 3102 3006 3054 3102 2958 2862 2910 2955
3521 3533 3486 3390 3438 3486 2577 2561 2578 0
3905 3917 3102 3006 3054 2286 3390 3438 3486 3387
0 3438 3486 3390 2769 2669 3006 3054 3102 3003
0 0 0 2370 2384 2276 3386 3434 3482 0
0 0 0 0 0 0 0 0 0 0
0 0 0 0 0 0 0 0 0 0
0 0 0 0 0 0 0 0 0 0
0 0 0 0 0 0 0 0 0 0
0 0 0 0 0 0 0 0 0 0
0 0 0 0 0 0 0 0 0 0
0 0 0 0 0 0 0 0 0 0
0 0 0 0 0 0 0 0 0 0
0 0 0 0 0 0 0 0 0 0
0 0 0 0 0 0 0 0 0 2274
