1536 1536 1536 1536 1536 1536 1536 1536 1536 1536 1536 1536 1536 1536 1536 1536 1536 1536 1536
1536 1536 1536 6787 6785 6785 6785 6775 6785 6785 6785 6775 6785 6785 6785 6789 1536 1536 1536
1536 1536 1536 6784 7143 7138 7143 6784 7143 7138 7143 6784 7143 7138 7143 6784 1536 1536 1536
1536 1536 1536 6784 7149 7144 7149 6784 7149 7144 7149 6784 7149 7144 7149 6784 1536 1536 1536
1536 1536 1536 6784 4098 4084 4100 6796 4110 4158 4110 6796 4098 4084 4100 6784 1536 1536 1536
1536 1536 1536 6784 4080 4064 4088 7143 4158 4110 4158 7143 4080 4064 4088 6784 1536 1536 1536
1536 1536 1536 6784 4104 4092 4102 7149 4110 4158 4110 7149 4104 4092 4102 6784 1536 1536 1536
1536 1536 1536 6784 2859 2849 2861 3243 3233 3223 3233 3245 2850 2836 2852 6784 1536 1536 1536
1536 1536 1536 6784 1536 4084 4100 6787 6797 3232 6795 6789 2832 2816 2840 6784 1536 1536 1536
1536 1536 1536 6784 1536 4064 4088 6784 7143 1577 7143 6784 2856 2844 2854 6784 1536 1536 1536
1536 1536 1536 6793 6785 6785 6785 6779 7149 1627 7149 6771 6785 6785 6785 6791 1536 1536 1536
1536 1536 1536 7139 7138 7138 7138 6784 1536 2887 1536 6784 7138 7138 7138 7142 1536 1536 1536
1536 1536 1536 7145 7144 7144 7144 6793 6797 2896 6795 6791 7144 7144 7144 7148 1536 1536 1536
1536 1536 1536 1536 1536 1536 1536 7139 7142 2896 7139 7142 1536 1536 1536 1536 1536 1536 1536
1536 1536 1536 1536 1536 1536 1536 7145 7148 2908 7145 7148 1536 1536 1536 1536 1536 1536 1536
1536 1536 1536 1536 1536 1536 1536 1536 1536 1536 1536 1536 1536 1536 1536 1536 1536 1536 1536
0 0 0 0 0 0 0 0 0 0 0 0 0 0 0 0 0 0 0
0 0 0 0 0 0 0 0 0 0 0 0 0 0 0 0 0 0 0
0 0 0 0 0 0 0 0 0 0 0 0 0 0 0 0 0 0 0
0 0 0 0 0 0 0 0 0 0 0 0 0 0 0 0 0 0 0
0 0 0 0 0 0 3194 0 0 0 0 0 0 0 0 0 0 0 0
0 0 0 0 0 0 3196 0 0 3198 0 0 0 0 0 0 0 0 0
0 0 0 0 0 0 0 0 0 0 0 0 0 0 0 0 0 0 0
0 0 0 0 0 0 0 0 0 0 0 0 0 0 0 0 0 0 0
0 0 0 0 3194 0 0 0 0 0 0 0 0 0 0 0 0 0 0
0 0 0 0 3196 3198 0 0 0 0 0 0 0 0 0 0 0 0 0
0 0 0 0 0 0 0 0 0 0 0 0 0 0 0 0 0 0 0
0 0 0 0 0 0 0 0 3582 0 3582 0 0 0 0 0 0 0 0
0 0 0 0 0 0 0 0 0 0 0 0 0 0 0 0 0 0 0
0 0 0 0 0 0 0 0 0 0 0 0 0 0 0 0 0 0 0
0 0 0 0 0 0 0 0 0 0 0 0 0 0 0 0 0 0 0
0 0 0 0 0 0 0 0 0 0 0 0 0 0 0 0 0 0 0
0 0 0 0 0 0 0 0 0 0 0 0 0 0 0 0 0 0 0
0 0 0 0 0 0 0 0 0 0 0 0 0 0 0 0 0 0 0
0 0 0 0 0 0 0 0 0 0 0 0 0 0 0 0 0 0 0
0 0 0 0 0 0 0 0 0 0 0 0 0 0 0 0 0 0 0
0 0 0 0 0 0 0 0 0 0 0 0 0 0 0 0 0 0 0
0 0 0 0 0 0 0 0 0 0 0 0 0 0 0 0 0 0 0
0 0 0 0 0 0 0 0 0 0 0 0 0 0 0 0 0 0 0
0 0 0 0 0 0 0 0 0 0 0 0 0 0 0 0 0 0 0
0 0 0 0 0 0 0 0 0 0 0 0 0 0 0 0 0 0 0
0 0 0 0 0 0 0 0 0 0 0 0 0 0 0 0 0 0 0
0 0 0 0 0 0 0 0 0 0 0 0 0 0 0 0 0 0 0
0 0 0 0 0 0 0 0 0 0 0 0 0 0 0 0 0 0 0
0 0 0 0 0 0 0 0 0 0 0 0 0 0 0 0 0 0 0
0 0 0 0 0 0 0 0 0 0 0 0 0 0 0 0 0 0 0
0 0 0 0 0 0 0 0 0 0 0 0 0 0 0 0 0 0 0
0 0 0 0 0 0 0 0 0 0 0 0 0 0 0 0 0 0 0
0 0 0 0 0 0 0 0 0 0 0 0 0 0 0 0 0 0 0
0 0 0 0 0 0 0 0 0 0 0 0 0 0 0 0 0 0 0
0 0 0 0 192 187 193 0 0 68 0 0 117 69 134 0 0 0 0
0 0 0 0 0 195 0 0 152 76 153 0 125 77 0 0 0 0 0
0 0 0 0 211 122 361 0 160 124 161 0 171 124 168 0 0 0 0
0 0 0 0 0 0 363 0 120 0 120 0 179 0 176 0 0 0 0
0 0 0 0 0 0 212 0 0 0 0 0 0 0 0 0 0 0 0
0 0 0 0 0 0 0 0 0 0 0 0 0 0 0 0 0 0 0
0 0 0 0 339 122 0 0 0 0 0 0 0 0 0 0 0 0 0
0 0 0 0 327 324 243 0 132 0 0 0 242 212 212 0 0 0 0
0 0 0 0 0 0 0 0 0 0 0 0 0 0 0 0 0 0 0
0 0 0 0 0 0 0 0 341 0 341 0 0 0 0 0 0 0 0
0 0 0 0 0 0 0 0 0 0 0 0 0 0 0 0 0 0 0
0 0 0 0 0 0 0 0 0 0 0 0 0 0 0 0 0 0 0
0 0 0 0 0 0 0 0 0 0 0 0 0 0 0 0 0 0 0
0 0 0 0 0 0 0 0 0 0 0 0 0 0 0 0 0 0 0
0 0 0 0 0 0 0 0 0 0 0 0 0 0 0 0 0 0 0
0 0 0 0 0 0 0 0 0 0 0 0 0 0 0 0 0 0 0
0 0 0 0 5 0 0 0 5 0 0 0 5 0 0 0 5 0 0
0 0 0 0 5 0 0 0 1 4 0 0 5 0 0 0 5 0 0
0 0 0 0 5 0 0 0 5 5 0 0 5 4 0 0 5 0 0
0 0 0 0 5 0 0 0 5 0 0 0 5 5 0 0 5 0 0
0 0 0 0 5 0 0 0 5 0 0 0 5 0 0 0 5 0 0
0 0 0 0 5 0 0 0 0 0 0 0 0 0 0 0 5 0 0
0 0 0 0 5 0 0 0 0 0 0 0 0 0 0 0 5 0 0
0 0 0 0 5 0 0 0 5 5 0 0 5 0 0 0 5 0 0
0 0 0 0 0 0 0 0 5 5 0 0 0 0 0 0 5 0 0
0 0 0 0 0 0 0 0 5 5 0 0 5 0 0 0 5 0 0
0 0 0 0 0 0 0 0 0 5 0 0 5 0 0 0 5 0 0
0 0 0 0 0 0 0 0 0 5 0 0 5 0 0 0 0 0 0
0 0 0 0 0 0 0 0 0 5 0 0 5 0 0 0 0 0 0
0 0 0 0 0 0 0 0 0 0 0 0 0 0 0 0 0 0 0
0 0 0 0 0 0 0 0 0 0 0 0 0 0 0 0 0 0 0