2816 2816 2816 2816 2816 2816 2816 2816 2816 2816
2816 2816 2816 2816 2816 2816 2816 2816 2816 2816
2816 2816 2816 2816 2816 2816 2816 2816 2816 2816
2816 2816 2816 2816 2816 2816 2816 2816 2816 2816
2816 2816 2816 2816 2816 2816 2816 2816 2816 2816
2816 2816 2816 2816 2816 2816 2816 2816 2816 2816
2816 2816 2816 2816 2816 2816 2816 2816 2816 2816
2816 2816 2816 2816 2816 2816 2816 2816 2816 2816
2816 2816 2816 2816 2816 2816 2816 2816 2816 2816
2816 2816 2816 2816 2816 2816 2816 2816 2816 2816
0 0 0 0 0 0 0 0 0 0
0 0 3042 3044 0 0 176 177 0 0
0 0 3048 3046 0 0 184 185 0 0
0 0 0 0 0 0 0 0 0 0
0 3530 0 29 30 31 0 3530 0 0
0 3520 0 37 38 39 0 3520 0 0
0 3520 0 45 46 47 0 3520 0 0
0 3529 3521 3533 0 3531 3521 3527 0 0
0 0 0 0 0 0 0 0 0 0
0 0 0 0 0 0 0 0 0 0
0 0 0 0 0 0 0 0 0 0
0 0 0 0 0 0 0 0 0 0
0 0 0 0 0 0 0 0 0 0
0 0 0 0 0 0 0 0 0 0
0 0 0 0 0 0 0 0 0 0
0 0 0 0 0 0 0 0 0 0
0 0 0 0 0 0 0 0 0 0
0 0 0 0 0 0 0 0 0 0
0 0 0 0 0 0 0 0 0 0
0 0 0 0 0 0 0 0 0 0
0 0 0 0 0 0 0 0 0 0
0 0 0 0 0 0 0 0 0 0
0 0 0 0 0 0 0 0 0 0
0 0 0 0 0 0 0 0 0 0
0 0 0 0 0 0 0 0 0 0
0 0 0 0 0 0 0 0 0 0
0 0 0 0 0 0 0 0 0 0
0 0 0 0 0 0 0 0 0 0