2048 2048 2048 2048 2048 2048 2048 2048 2048 2048
2048 2048 2052 2076 2076 2056 2048 2048 2048 2048
2048 2048 2072 2850 2852 2088 2060 2076 2076 2076
2048 2052 2086 2832 2818 2852 2080 1624 1625 1625
2048 2072 2850 2817 2816 2840 2092 1632 1633 1633
2048 2072 2832 2816 2816 2818 2852 1640 1641 1641
2048 2072 2856 2844 2844 2824 2840 1648 1649 1649
2048 2050 2068 2068 2084 2832 2840 1656 1657 1657
2048 2048 2048 2048 2072 2856 2826 2836 2836 2836
2048 2048 2048 2048 2050 2084 2832 2816 2816 2816
2192 2192 2192 2192 2192 2192 2192 2192 2192 2192
2192 2192 2196 2220 2220 2200 2192 2192 2192 2192
2192 2192 2216 0 0 2232 2204 2220 2220 2220
2192 2196 2230 29 30 31 2224 0 0 0
2192 2216 236 37 38 39 2236 0 0 0
2192 2216 244 45 46 47 0 0 0 0
2192 2216 0 0 0 0 0 0 0 0
2192 2194 2212 2212 2228 0 0 0 0 0
2192 2192 2192 2192 2216 0 0 0 0 0
2192 2192 2192 2192 2194 2228 0 0 0 0
0 0 0 0 0 0 0 0 0 0
0 0 0 176 177 0 0 0 0 0
0 0 0 184 185 0 0 0 0 0
0 0 0 0 0 0 0 0 0 0
0 0 0 0 0 0 0 0 0 0
0 0 0 0 0 0 0 0 0 0
0 0 0 0 0 0 0 0 0 0
0 0 0 0 0 0 0 0 0 0
0 0 0 0 0 0 0 0 0 0
0 0 0 0 0 0 0 0 0 0
0 0 0 0 0 0 0 0 0 0
0 0 0 0 0 0 0 0 0 0
0 0 0 0 0 0 0 0 0 0
0 0 0 0 0 0 0 0 0 0
0 0 0 0 0 0 0 0 0 0
0 0 0 0 0 0 0 0 0 0
0 0 0 0 0 0 0 0 0 0
0 0 0 0 0 0 0 0 0 0
0 0 0 0 0 0 0 0 0 0
0 0 0 0 0 0 0 0 0 0
0 0 0 0 0 0 0 0 0 0
0 0 0 0 0 0 0 0 0 0
0 0 0 0 0 0 0 0 0 0
0 0 0 0 0 0 0 0 0 0
0 0 0 0 0 0 0 0 0 0
0 0 0 0 0 0 0 0 0 0
0 0 0 0 0 0 0 0 0 0
0 0 0 0 0 0 0 0 0 0
0 0 0 0 0 0 0 0 0 0
0 0 0 0 0 0 0 0 0 0
0 0 0 0 0 0 0 0 0 0