0 0 0 0 0 0 0 0 0 0
0 1537 5982 6030 6078 6126 6174 6222 6270 0
0 6283 6330 6378 6426 6474 6522 6570 6622 0
0 6702 6750 6798 6846 6894 6942 6990 7038 0
0 7055 7103 7151 7199 7247 7295 7343 7391 0
0 0 0 0 0 0 0 0 0 0
0 7470 7518 7566 7614 7662 7710 7758 7806 0
0 7823 7871 7919 7967 8015 8063 8111 8159 0
0 0 0 0 0 0 0 0 0 0
0 0 0 0 0 0 0 0 0 0
0 0 0 0 0 0 0 0 0 0
0 0 0 0 0 0 0 0 0 0
0 0 0 0 0 0 0 0 0 0
0 0 0 0 0 0 0 0 0 0
0 0 0 0 0 0 0 0 0 0
0 0 0 0 0 0 0 0 0 0
0 0 0 0 0 0 0 0 0 0
0 0 0 0 0 0 0 0 0 0
0 0 0 0 0 0 0 0 0 0
0 0 0 0 0 0 0 0 0 0
0 0 0 0 0 0 0 0 0 0