2048 2048 2048 2048 2048 2048 2048 2048 2048 2048
2048 2052 2076 2076 2076 2076 2076 2076 2056 2048
2048 2072 2274 2276 2562 2564 2850 2852 2064 2048
2048 2072 2280 2278 2568 2566 2856 2854 2064 2048
2048 2072 2370 2372 3714 3716 3234 3236 2064 2048
2048 2072 2376 2374 3720 3718 3240 3238 2064 2048
2048 2072 2466 2468 2658 2660 4002 4004 2064 2048
2048 2072 2472 2470 2664 2662 4008 4006 2064 2048
2048 2050 2068 2068 2068 2068 2068 2068 2053 2076
2048 2048 2048 2048 2048 2048 2048 2048 2072 2850
2888 2289 2384 2480 2576 2672 2770 2880 2864 2864
2866 2884 2884 2884 2884 2884 2884 2865 2864 2864
2864 2864 2864 2864 2864 2864 2864 2864 2864 2864
2864 2864 2864 2864 2864 2864 2864 2864 2864 2864
2864 2864 2864 2864 2864 2864 2864 2864 2864 2864
2864 2864 2864 2864 2864 2864 2864 2864 2864 2864
2864 2864 2864 2864 2864 2864 2864 2864 2864 2864
2864 2864 2864 2864 2864 2864 2864 2864 2864 2864
2864 2864 2864 2864 2864 2864 2864 2864 2864 2864
2864 2864 2864 2864 2864 2864 2864 2864 2864 2864