1552 2856 2844 2844 2844 2844 2844 2854 1552 1552 1552 1552 1552 1552 1552 1552 1552 1552 1552 1552 1552 2856 2844 2844 2844 2844 2844 2854 1552 1552 1552 1552 1552 1552 1552 1552 1552 1552 1552 1552
2852 1552 1552 1552 1552 1552 1552 1552 1552 1552 1552 1552 1552 1552 1552 1552 1552 1552 1552 1552 1552 2856 2844 2844 2844 2844 2844 2854 1552 1552 1552 1552 1552 1552 1552 1552 1552 1552 1552 1552
2854 1552 1552 1552 1552 1552 1552 1552 1552 1552 1552 1552 1552 1552 1552 1552 1552 1552 1552 1552 1552 2856 2844 2844 2844 2844 2844 2854 1552 1552 1552 1552 1552 1552 1552 1552 1552 1552 1552 1552
1552 1552 1552 1552 1552 1552 1552 1552 1552 1552 1552 1552 1552 1552 1552 1552 1552 1552 1552 1552 1552 2856 2844 2844 2844 2844 2844 2854 1552 1552 1552 1552 1552 1552 1552 1552 1552 1552 1552 1552
1552 1552 1552 1552 1552 1552 1552 1552 1552 1552 1552 1552 1552 1552 1552 1552 1552 1552 1552 1552 1552 2856 2844 2844 2844 2844 2844 2854 1552 1552 1552 1552 1552 1552 1552 1552 1552 1552 1552 1552
1552 1552 1552 1552 1552 1552 1552 1552 1552 2862 1552 1552 1552 1552 1552 1552 1552 1552 1552 1552 1552 2856 2844 2844 2844 2844 2844 2854 1552 1552 1552 1552 1552 1552 1552 1552 1552 1552 1552 1552
1552 1552 1552 1552 1552 1552 1552 1552 1552 1552 1552 1552 1552 1552 1552 1552 1552 1552 1552 1552 1552 2856 2844 2844 2844 2844 2844 2854 1552 1552 1552 1552 1552 1552 1552 1552 1552 1552 1552 1552
1552 2858 1552 1552 1552 1552 1552 1552 1552 1552 1552 1552 1552 1552 1552 1552 1552 1552 1552 1552 1552 2856 2844 2844 2844 2844 2844 2854 1552 1552 1552 1552 1552 1552 1552 1552 1552 1552 1552 1552
2836 2842 1552 1552 1552 1552 1552 1552 1552 1552 1552 1552 1552 1552 1552 1552 1552 1552 1552 1552 1552 2856 2844 2844 2844 2844 2844 2854 1552 1552 1552 1552 1552 1552 1552 1552 1552 1552 1552 1552
2816 2840 1552 2858 1552 1552 1552 1552 1552 1552 1552 1552 1552 1552 1552 1552 1552 1552 1552 1552 1552 2856 2844 2844 2844 2844 2844 2854 1552 1552 1552 1552 1552 1552 1552 1552 1552 1552 1552 1552
1552 2856 2844 2844 2844 2844 2844 2854 1552 1552 1552 1552 1552 1552 1552 1552 1552 1552 1552 1552 1552 2856 2844 2844 2844 2844 2844 2854 1552 1552 1552 1552 1552 1552 1552 1552 1552 1552 1552 1552
2852 1552 1552 1552 1552 1552 1552 1552 1552 1552 1552 1552 1552 1552 1552 1552 1552 1552 1552 1552 1552 2856 2844 2844 2844 2844 2844 2854 1552 1552 1552 1552 1552 1552 1552 1552 1552 1552 1552 1552
2854 1552 1552 1552 1552 1552 1552 1552 1552 1552 1552 1552 1552 1552 1552 1552 1552 1552 1552 1552 1552 2856 2844 2844 2844 2844 2844 2854 1552 1552 1552 1552 1552 1552 1552 1552 1552 1552 1552 1552
1552 1552 1552 1552 1552 1552 1552 1552 1552 1552 1552 1552 1552 1552 1552 1552 1552 1552 1552 1552 1552 2856 2844 2844 2844 2844 2844 2854 1552 1552 1552 1552 1552 1552 1552 1552 1552 1552 1552 1552
1552 1552 1552 1552 1552 1552 1552 1552 1552 1552 1552 1552 1552 1552 1552 1552 1552 1552 1552 1552 1552 2856 2844 2844 2844 2844 2844 2854 1552 1552 1552 1552 1552 1552 1552 1552 1552 1552 1552 1552
1552 1552 1552 1552 1552 1552 1552 1552 1552 2862 1552 1552 1552 1552 1552 1552 1552 1552 1552 1552 1552 2856 2844 2844 2844 2844 2844 2854 1552 1552 1552 1552 1552 1552 1552 1552 1552 1552 1552 1552
1552 1552 1552 1552 1552 1552 1552 1552 1552 1552 1552 1552 1552 1552 1552 1552 1552 1552 1552 1552 1552 2856 2844 2844 2844 2844 2844 2854 1552 1552 1552 1552 1552 1552 1552 1552 1552 1552 1552 1552
1552 2858 1552 1552 1552 1552 1552 1552 1552 1552 1552 1552 1552 1552 1552 1552 1552 1552 1552 1552 1552 2856 2844 2844 2844 2844 2844 2854 1552 1552 1552 1552 1552 1552 1552 1552 1552 1552 1552 1552
2836 2842 1552 1552 1552 1552 1552 1552 1552 1552 1552 1552 1552 1552 1552 1552 1552 1552 1552 1552 1552 2856 2844 2844 2844 2844 2844 2854 1552 1552 1552 1552 1552 1552 1552 1552 1552 1552 1552 1552
2816 2840 1552 2858 1552 1552 1552 1552 1552 1552 1552 1552 1552 1552 1552 1552 1552 1552 1552 1552 1552 2856 2844 2844 2844 2844 2844 2854 1552 1552 1552 1552 1552 1552 1552 1552 1552 1552 1552 1552
1552 2856 2844 2844 2844 2844 2844 2854 1552 1552 1552 1552 1552 1552 1552 1552 1552 1552 1552 1552 1552 2856 2844 2844 2844 2844 2844 2854 1552 1552 1552 1552 1552 1552 1552 1552 1552 1552 1552 1552
2852 1552 1552 1552 1552 1552 1552 1552 1552 1552 1552 1552 1552 1552 1552 1552 1552 1552 1552 1552 1552 2856 2844 2844 2844 2844 2844 2854 1552 1552 1552 1552 1552 1552 1552 1552 1552 1552 1552 1552
2854 1552 1552 1552 1552 1552 1552 1552 1552 1552 1552 1552 1552 1552 1552 1552 1552 1552 1552 1552 1552 2856 2844 2844 2844 2844 2844 2854 1552 1552 1552 1552 1552 1552 1552 1552 1552 1552 1552 1552
1552 1552 1552 1552 1552 1552 1552 1552 1552 1552 1552 1552 1552 1552 1552 1552 1552 1552 1552 1552 1552 2856 2844 2844 2844 2844 2844 2854 1552 1552 1552 1552 1552 1552 1552 1552 1552 1552 1552 1552
1552 1552 1552 1552 1552 1552 1552 1552 1552 1552 1552 1552 1552 1552 1552 1552 1552 1552 1552 1552 1552 2856 2844 2844 2844 2844 2844 2854 1552 1552 1552 1552 1552 1552 1552 1552 1552 1552 1552 1552
1552 1552 1552 1552 1552 1552 1552 1552 1552 2862 1552 1552 1552 1552 1552 1552 1552 1552 1552 1552 1552 2856 2844 2844 2844 2844 2844 2854 1552 1552 1552 1552 1552 1552 1552 1552 1552 1552 1552 1552
1552 1552 1552 1552 1552 1552 1552 1552 1552 1552 1552 1552 1552 1552 1552 1552 1552 1552 1552 1552 1552 2856 2844 2844 2844 2844 2844 2854 1552 1552 1552 1552 1552 1552 1552 1552 1552 1552 1552 1552
1552 2858 1552 1552 1552 1552 1552 1552 1552 1552 1552 1552 1552 1552 1552 1552 1552 1552 1552 1552 1552 2856 2844 2844 2844 2844 2844 2854 1552 1552 1552 1552 1552 1552 1552 1552 1552 1552 1552 1552
2836 2842 1552 1552 1552 1552 1552 1552 1552 1552 1552 1552 1552 1552 1552 1552 1552 1552 1552 1552 1552 2856 2844 2844 2844 2844 2844 2854 1552 1552 1552 1552 1552 1552 1552 1552 1552 1552 1552 1552
2816 2840 1552 2858 1552 1552 1552 1552 1552 1552 1552 1552 1552 1552 1552 1552 1552 1552 1552 1552 1552 2856 2844 2844 2844 2844 2844 2854 1552 1552 1552 1552 1552 1552 1552 1552 1552 1552 1552 1552
1552 2856 2844 2844 2844 2844 2844 2854 1552 1552 1552 1552 1552 1552 1552 1552 1552 1552 1552 1552 1552 2856 2844 2844 2844 2844 2844 2854 1552 1552 1552 1552 1552 1552 1552 1552 1552 1552 1552 1552
2852 1552 1552 1552 1552 1552 1552 1552 1552 1552 1552 1552 1552 1552 1552 1552 1552 1552 1552 1552 1552 2856 2844 2844 2844 2844 2844 2854 1552 1552 1552 1552 1552 1552 1552 1552 1552 1552 1552 1552
2854 1552 1552 1552 1552 1552 1552 1552 1552 1552 1552 1552 1552 1552 1552 1552 1552 1552 1552 1552 1552 2856 2844 2844 2844 2844 2844 2854 1552 1552 1552 1552 1552 1552 1552 1552 1552 1552 1552 1552
1552 1552 1552 1552 1552 1552 1552 1552 1552 1552 1552 1552 1552 1552 1552 1552 1552 1552 1552 1552 1552 2856 2844 2844 2844 2844 2844 2854 1552 1552 1552 1552 1552 1552 1552 1552 1552 1552 1552 1552
1552 1552 1552 1552 1552 1552 1552 1552 1552 1552 1552 1552 1552 1552 1552 1552 1552 1552 1552 1552 1552 2856 2844 2844 2844 2844 2844 2854 1552 1552 1552 1552 1552 1552 1552 1552 1552 1552 1552 1552
1552 1552 1552 1552 1552 1552 1552 1552 1552 2862 1552 1552 1552 1552 1552 1552 1552 1552 1552 1552 1552 2856 2844 2844 2844 2844 2844 2854 1552 1552 1552 1552 1552 1552 1552 1552 1552 1552 1552 1552
1552 1552 1552 1552 1552 1552 1552 1552 1552 1552 1552 1552 1552 1552 1552 1552 1552 1552 1552 1552 1552 2856 2844 2844 2844 2844 2844 2854 1552 1552 1552 1552 1552 1552 1552 1552 1552 1552 1552 1552
1552 2858 1552 1552 1552 1552 1552 1552 1552 1552 1552 1552 1552 1552 1552 1552 1552 1552 1552 1552 1552 2856 2844 2844 2844 2844 2844 2854 1552 1552 1552 1552 1552 1552 1552 1552 1552 1552 1552 1552
2836 2842 1552 1552 1552 1552 1552 1552 1552 1552 1552 1552 1552 1552 1552 1552 1552 1552 1552 1552 1552 2856 2844 2844 2844 2844 2844 2854 1552 1552 1552 1552 1552 1552 1552 1552 1552 1552 1552 1552
2816 2840 1552 2858 1552 1552 1552 1552 1552 1552 1552 1552 1552 1552 1552 1552 1552 1552 1552 1552 1552 2856 2844 2844 2844 2844 2844 2854 1552 1552 1552 1552 1552 1552 1552 1552 1552 1552 1552 1552
1552 2856 2844 2844 2844 2844 2844 2854 1552 1552 1552 1552 1552 1552 1552 1552 1552 1552 1552 1552 1552 2856 2844 2844 2844 2844 2844 2854 1552 1552 1552 1552 1552 1552 1552 1552 1552 1552 1552 1552
2852 1552 1552 1552 1552 1552 1552 1552 1552 1552 1552 1552 1552 1552 1552 1552 1552 1552 1552 1552 1552 2856 2844 2844 2844 2844 2844 2854 1552 1552 1552 1552 1552 1552 1552 1552 1552 1552 1552 1552
2854 1552 1552 1552 1552 1552 1552 1552 1552 1552 1552 1552 1552 1552 1552 1552 1552 1552 1552 1552 1552 2856 2844 2844 2844 2844 2844 2854 1552 1552 1552 1552 1552 1552 1552 1552 1552 1552 1552 1552
1552 1552 1552 1552 1552 1552 1552 1552 1552 1552 1552 1552 1552 1552 1552 1552 1552 1552 1552 1552 1552 2856 2844 2844 2844 2844 2844 2854 1552 1552 1552 1552 1552 1552 1552 1552 1552 1552 1552 1552
1552 1552 1552 1552 1552 1552 1552 1552 1552 1552 1552 1552 1552 1552 1552 1552 1552 1552 1552 1552 1552 2856 2844 2844 2844 2844 2844 2854 1552 1552 1552 1552 1552 1552 1552 1552 1552 1552 1552 1552
1552 1552 1552 1552 1552 1552 1552 1552 1552 2862 1552 1552 1552 1552 1552 1552 1552 1552 1552 1552 1552 2856 2844 2844 2844 2844 2844 2854 1552 1552 1552 1552 1552 1552 1552 1552 1552 1552 1552 1552
1552 1552 1552 1552 1552 1552 1552 1552 1552 1552 1552 1552 1552 1552 1552 1552 1552 1552 1552 1552 1552 2856 2844 2844 2844 2844 2844 2854 1552 1552 1552 1552 1552 1552 1552 1552 1552 1552 1552 1552
1552 2858 1552 1552 1552 1552 1552 1552 1552 1552 1552 1552 1552 1552 1552 1552 1552 1552 1552 1552 1552 2856 2844 2844 2844 2844 2844 2854 1552 1552 1552 1552 1552 1552 1552 1552 1552 1552 1552 1552
2836 2842 1552 1552 1552 1552 1552 1552 1552 1552 1552 1552 1552 1552 1552 1552 1552 1552 1552 1552 1552 2856 2844 2844 2844 2844 2844 2854 1552 1552 1552 1552 1552 1552 1552 1552 1552 1552 1552 1552
2816 2840 1552 2858 1552 1552 1552 1552 1552 1552 1552 1552 1552 1552 1552 1552 1552 1552 1552 1552 1552 2856 2844 2844 2844 2844 2844 2854 1552 1552 1552 1552 1552 1552 1552 1552 1552 1552 1552 1552
1552 2856 2844 2844 2844 2844 2844 2854 1552 1552 1552 1552 1552 1552 1552 1552 1552 1552 1552 1552 1552 2856 2844 2844 2844 2844 2844 2854 1552 1552 1552 1552 1552 1552 1552 1552 1552 1552 1552 1552
2852 1552 1552 1552 1552 1552 1552 1552 1552 1552 1552 1552 1552 1552 1552 1552 1552 1552 1552 1552 1552 2856 2844 2844 2844 2844 2844 2854 1552 1552 1552 1552 1552 1552 1552 1552 1552 1552 1552 1552
2854 1552 1552 1552 1552 1552 1552 1552 1552 1552 1552 1552 1552 1552 1552 1552 1552 1552 1552 1552 1552 2856 2844 2844 2844 2844 2844 2854 1552 1552 1552 1552 1552 1552 1552 1552 1552 1552 1552 1552
1552 1552 1552 1552 1552 1552 1552 1552 1552 1552 1552 1552 1552 1552 1552 1552 1552 1552 1552 1552 1552 2856 2844 2844 2844 2844 2844 2854 1552 1552 1552 1552 1552 1552 1552 1552 1552 1552 1552 1552
1552 1552 1552 1552 1552 1552 1552 1552 1552 1552 1552 1552 1552 1552 1552 1552 1552 1552 1552 1552 1552 2856 2844 2844 2844 2844 2844 2854 1552 1552 1552 1552 1552 1552 1552 1552 1552 1552 1552 1552
1552 1552 1552 1552 1552 1552 1552 1552 1552 2862 1552 1552 1552 1552 1552 1552 1552 1552 1552 1552 1552 2856 2844 2844 2844 2844 2844 2854 1552 1552 1552 1552 1552 1552 1552 1552 1552 1552 1552 1552
1552 1552 1552 1552 1552 1552 1552 1552 1552 1552 1552 1552 1552 1552 1552 1552 1552 1552 1552 1552 1552 2856 2844 2844 2844 2844 2844 2854 1552 1552 1552 1552 1552 1552 1552 1552 1552 1552 1552 1552
1552 2858 1552 1552 1552 1552 1552 1552 1552 1552 1552 1552 1552 1552 1552 1552 1552 1552 1552 1552 1552 2856 2844 2844 2844 2844 2844 2854 1552 1552 1552 1552 1552 1552 1552 1552 1552 1552 1552 1552
2836 2842 1552 1552 1552 1552 1552 1552 1552 1552 1552 1552 1552 1552 1552 1552 1552 1552 1552 1552 1552 2856 2844 2844 2844 2844 2844 2854 1552 1552 1552 1552 1552 1552 1552 1552 1552 1552 1552 1552
2816 2840 1552 2858 1552 1552 1552 1552 1552 1552 1552 1552 1552 1552 1552 1552 1552 1552 1552 1552 1552 2856 2844 2844 2844 2844 2844 2854 1552 1552 1552 1552 1552 1552 1552 1552 1552 1552 1552 1552
1552 2856 2844 2844 2844 2844 2844 2854 1552 1552 1552 1552 1552 1552 1552 1552 1552 1552 1552 1552 1552 2856 2844 2844 2844 2844 2844 2854 1552 1552 1552 1552 1552 1552 1552 1552 1552 1552 1552 1552
2852 1552 1552 1552 1552 1552 1552 1552 1552 1552 1552 1552 1552 1552 1552 1552 1552 1552 1552 1552 1552 2856 2844 2844 2844 2844 2844 2854 1552 1552 1552 1552 1552 1552 1552 1552 1552 1552 1552 1552
2854 1552 1552 1552 1552 1552 1552 1552 1552 1552 1552 1552 1552 1552 1552 1552 1552 1552 1552 1552 1552 2856 2844 2844 2844 2844 2844 2854 1552 1552 1552 1552 1552 1552 1552 1552 1552 1552 1552 1552
1552 1552 1552 1552 1552 1552 1552 1552 1552 1552 1552 1552 1552 1552 1552 1552 1552 1552 1552 1552 1552 2856 2844 2844 2844 2844 2844 2854 1552 1552 1552 1552 1552 1552 1552 1552 1552 1552 1552 1552
1552 1552 1552 1552 1552 1552 1552 1552 1552 1552 1552 1552 1552 1552 1552 1552 1552 1552 1552 1552 1552 2856 2844 2844 2844 2844 2844 2854 1552 1552 1552 1552 1552 1552 1552 1552 1552 1552 1552 1552
1552 1552 1552 1552 1552 1552 1552 1552 1552 2862 1552 1552 1552 1552 1552 1552 1552 1552 1552 1552 1552 2856 2844 2844 2844 2844 2844 2854 1552 1552 1552 1552 1552 1552 1552 1552 1552 1552 1552 1552
1552 1552 1552 1552 1552 1552 1552 1552 1552 1552 1552 1552 1552 1552 1552 1552 1552 1552 1552 1552 1552 2856 2844 2844 2844 2844 2844 2854 1552 1552 1552 1552 1552 1552 1552 1552 1552 1552 1552 1552
1552 2858 1552 1552 1552 1552 1552 1552 1552 1552 1552 1552 1552 1552 1552 1552 1552 1552 1552 1552 1552 2856 2844 2844 2844 2844 2844 2854 1552 1552 1552 1552 1552 1552 1552 1552 1552 1552 1552 1552
2836 2842 1552 1552 1552 1552 1552 1552 1552 1552 1552 1552 1552 1552 1552 1552 1552 1552 1552 1552 1552 2856 2844 2844 2844 2844 2844 2854 1552 1552 1552 1552 1552 1552 1552 1552 1552 1552 1552 1552
2816 2840 1552 2858 1552 1552 1552 1552 1552 1552 1552 1552 1552 1552 1552 1552 1552 1552 1552 1552 1552 2856 2844 2844 2844 2844 2844 2854 1552 1552 1552 1552 1552 1552 1552 1552 1552 1552 1552 1552
1552 2856 2844 2844 2844 2844 2844 2854 1552 1552 1552 1552 1552 1552 1552 1552 1552 1552 1552 1552 1552 2856 2844 2844 2844 2844 2844 2854 1552 1552 1552 1552 1552 1552 1552 1552 1552 1552 1552 1552
2852 1552 1552 1552 1552 1552 1552 1552 1552 1552 1552 1552 1552 1552 1552 1552 1552 1552 1552 1552 1552 2856 2844 2844 2844 2844 2844 2854 1552 1552 1552 1552 1552 1552 1552 1552 1552 1552 1552 1552
2854 1552 1552 1552 1552 1552 1552 1552 1552 1552 1552 1552 1552 1552 1552 1552 1552 1552 1552 1552 1552 2856 2844 2844 2844 2844 2844 2854 1552 1552 1552 1552 1552 1552 1552 1552 1552 1552 1552 1552
1552 1552 1552 1552 1552 1552 1552 1552 1552 1552 1552 1552 1552 1552 1552 1552 1552 1552 1552 1552 1552 2856 2844 2844 2844 2844 2844 2854 1552 1552 1552 1552 1552 1552 1552 1552 1552 1552 1552 1552
1552 1552 1552 1552 1552 1552 1552 1552 1552 1552 1552 1552 1552 1552 1552 1552 1552 1552 1552 1552 1552 2856 2844 2844 2844 2844 2844 2854 1552 1552 1552 1552 1552 1552 1552 1552 1552 1552 1552 1552
1552 1552 1552 1552 1552 1552 1552 1552 1552 2862 1552 1552 1552 1552 1552 1552 1552 1552 1552 1552 1552 2856 2844 2844 2844 2844 2844 2854 1552 1552 1552 1552 1552 1552 1552 1552 1552 1552 1552 1552
1552 1552 1552 1552 1552 1552 1552 1552 1552 1552 1552 1552 1552 1552 1552 1552 1552 1552 1552 1552 1552 2856 2844 2844 2844 2844 2844 2854 1552 1552 1552 1552 1552 1552 1552 1552 1552 1552 1552 1552
1552 2858 1552 1552 1552 1552 1552 1552 1552 1552 1552 1552 1552 1552 1552 1552 1552 1552 1552 1552 1552 2856 2844 2844 2844 2844 2844 2854 1552 1552 1552 1552 1552 1552 1552 1552 1552 1552 1552 1552
2836 2842 1552 1552 1552 1552 1552 1552 1552 1552 1552 1552 1552 1552 1552 1552 1552 1552 1552 1552 1552 2856 2844 2844 2844 2844 2844 2854 1552 1552 1552 1552 1552 1552 1552 1552 1552 1552 1552 1552
2816 2840 1552 2858 1552 1552 1552 1552 1552 1552 1552 1552 1552 1552 1552 1552 1552 1552 1552 1552 1552 2856 2844 2844 2844 2844 2844 2854 1552 1552 1552 1552 1552 1552 1552 1552 1552 1552 1552 1552
2816 2840 1552 2858 1552 1552 1552 1552 1552 1552 1552 1552 1552 1552 1552 1552 1552 1552 1552 1552 1552 2856 2844 2844 2844 2844 2844 2854 1552 1552 1552 1552 1552 1552 1552 1552 1552 1552 1552 1552
2816 2840 1552 2858 1552 1552 1552 1552 1552 1552 1552 1552 1552 1552 1552 1552 1552 1552 1552 1552 1552 2856 2844 2844 2844 2844 2844 2854 1552 1552 1552 1552 1552 1552 1552 1552 1552 1552 1552 1552
